1111111111111111111
1010000000000000001
1010101110111011101
1010101000001000001
1010100011101011101
1000001000101000001
1110111010101011101
1000000010000010001
1110101011101010111
1000101000000000001
1011101010101111101
1000000010000010001
1011111110111110111
1000000000000000001
1111111111111111111
